********************
*X*XXX*XXX*X*X*X*X*X
*X*********X*X*X*X*X
*XXXXX*XXXXXXXXXXXXX
********************
*X*X*X*X*X*XXX*XXX*X
*X*X*X*X*X*********X
*X*XXX*XXX*XXXXX*X*X
*X***************X*X
*X*XXXXX*XXXXXXXXX*X
*X*****************X
*XXXXX*XXX*XXX*XXX*X
*******************X
*X*XXXXX*X*XXXXX*X*X
*X*******X*******X*X
*XXX*XXX*X*XXX*XXXXX
*********X**********
*XXXXXXX*XXXXXXXXX*X
*******************X
*XXXXXXXXXXXXXXXXX**